All 2000 ➤
Maintenance Intervals - Edition 08.2011
• Windshield wiper and washer / Headlight washer - Check ad‐
justment and function and add fluid if necessary.
• Wiper arm pivot points - Lubricate
• Tires and spare wheel - Check for wear and damage. Check
tire pressure. Check renewal date of tire repair set (where ap‐
plicable).
• Engine on-board diagnostics - Check fault memory
• Battery - Check electrolyte level and add if necessary.
• Cooling system - Check coolant level and add coolant if nec‐
essary.
• Engine compartment - Check for leaks
• Exhaust system - Check for damage and leaks.
• Automatic transmission and final drive - Check for leaks.
• Manual transmission and final drive - Check for leaks.
• Underbody - Check for damage and leaks
• Drive shafts - Check boots.
• Front and rear axles - Check for excessive play. Check d ust
seals on ball joints and tie rod ends.
• Doors - Lubricate door check straps
• Rear lid hinges - lubricate (A8 only)
• Lights - Check all lights. Check headlight adjustment.
• Dust and pollen filter - Replace filter.
• Snow screen for air cleaner - Clean (A4 and A6 only).
• Road test - Check braking, kick-down, steering, electrical,
heating and ventilation systems, air conditioning, shift lock op‐
eration, and power accessories.
• Sunroof: clean guide rails and lubricate with grease spray
• Haldex clutch - Change oil (A3 and TT only)
• Haldex clutch - Change filter (TT only)
• Spark plugs - Replace (1.8T, 3.0L, 3.2L VR6, and 6.0L engines
only)
• Air cleaner - Clean the housing and replace filter element (TT
and A8 6.0L only).
• Continuously Variable Transmission (multitronic) - Change
ATF.
• Power steering fluid - Check fluid level. Add if necessary.
• DSG (direct shift gearbox) - Change oil and replace filter ele‐
ment (TT and A3 only)
• Ribbed V-belt - Check condition (A8 6.0L only)
• Ribbed V-belt - Replace (except 2.0T FSI, 3.0L, and 3.2L)
• Ribbed V-belt - Check condition (2.0T FSI, 3.0L, and 3.2L en‐
gines only)
• Timing belt - Replace (1.8T, 3.0L, and A8 4.2L only)
• Front sunroof drains (where applicable) - Open sunroof to
check front water drain and clean if necessary.
60
Rep. Gr.03 - Maintenance, Diagnosis